   ##############################################################################################################################################
 A    #           #     #              #     #     #        #     #              #              #  #  #  #           #        #     #  #        #
#  ##########  ####  #######  #  #######  ####  #  #  #  #  ####  ##########  ####  ####  #  ####  #  #  #  ####  #######  #  #  ####  #  #######
#           #     #  #  #     #        #        #     #  #        #        #  #     #  #  #  #              #        #  #  #     #     #     #  #
#  #  #######  ####  #  #  #######  #  #  ####  ##########  #######  ####  #  ####  #  #  #######  #  #######  #######  #  ####  #  ####  #  #  #
#  #           #  #           #     #        #     #     #  #           #        #  #     #     #  #     #  #  #  #  #     #  #     #     #  #  #
#  #######  #  #  #  ####  #######  #  #######  ####  #######  #######  ##########  ####  ####  #  #######  ####  #  #  ####  ####  #  #######  #
#  #        #           #     #  #  #        #  #  #  #     #  #  #     #              #        #  #  #        #  #     #  #  #     #           #
####  #  #######  ####  ####  #  ##########  #  #  #  #  #  ####  #  #  #  ####  ################  #  #  #######  #  #  #  #  ####  #  ####  ####
#     #     #  #     #     #        #  #     #           #  #        #        #           #        #     #           #     #  #  #        #     #
#######  #  #  #  ####  ##########  #  ##########  #  #  #############  ##########  #######  ####  ####  #  ####  #######  #  #  #  ####  ####  #
#        #  #        #  #  #  #     #  #     #     #  #  #     #  #           #                 #  #        #        #     #     #  #     #     #
####  ####  ##########  #  #  ####  #  #  #  #  #  #  #######  #  #  ####  #  ################  #######  ####  #  #######  ####  ################
#  #     #  #  #           #              #  #  #  #           #  #  #     #     #        #        #  #     #  #  #  #  #  #  #              #  #
#  ####  ####  #  ##########  #######  #  ####  #  #  #######  #  ################  #  ##########  #  #  #  ####  #  #  ####  #######  #######  #
#  #  #        #  #     #  #     #     #  #     #  #     #  #  #              #  #  #        #     #     #  #  #     #                 #        #
#  #  ####  #######  ####  ####  #  ###################  #  #  ##########  #  #  #  #  ##########  #  ####  #  ####  #######  ##########  #######
#        #  #                    #     #           #     #        #  #  #  #        #  #     #  #        #        #     #     #     #     #     #
#  ###################  ####  #  ##########  ######################  #  ##########  ####  ####  #  #############  #  #######  ####  #  #  #  ####
#     #                 #     #     #     #        #     #  #     #  #              #              #        #  #  #     #        #  #  #        #
####  #  #############  #  ##########  #  #  ##########  #  ####  #  #############  #  ####  ##########  ####  #  ##########  ####  #  #######  #
#  #  #     #        #  #           #  #              #     #              #  #     #  #     #  #           #        #        #              #  #
#  #  #  #  ####  #  #  #  ####  #  #######  ####  #######  #  #  ####  ####  ####  ####  ####  ####  #  ####  ####  ####  #  #  ##########  ####
#  #  #  #     #  #     #     #  #     #  #  #        #     #  #     #  #  #  #  #              #  #  #        #        #  #  #  #  #           #
#  #  ####  ###################  #  ####  ##########  ####  #  ##########  #  #  #  #  #######  #  ##########  #  ####  #  ####  #  ####  ####  #
#           #  #  #              #  #                 #                 #           #  #     #     #  #  #  #  #  #           #     #        #  #
#######  ####  #  #######  #  ####  ####  #  ################  ##########  #  #  ####  #  ####  #  #  #  #  #############  #######  ####  #  ####
#  #        #  #  #  #     #  #     #     #     #           #           #  #  #     #        #  #     #  #  #     #  #                 #  #  #  #
#  #  #######  #  #  #######  ####  #  ####  #######  ##########  #######  #  ####  ##########  ####  #  #  #  ####  #  ####  ################  #
#  #  #              #     #  #           #     #           #  #  #  #  #  #  #     #           #     #     #     #        #  #     #           #
#  ####  ####  #######  #  #######  #  ##########  #  ####  #  #  #  #  ##########  #  ####  #######  #  #######  #  #######  #  #############  #
#  #        #     #  #  #           #        #     #  #     #  #  #  #  #        #  #  #  #  #        #  #        #  #           #     #        #
#  #  ##########  #  ####  ####  ####  ####  #  #############  #  #  #  ####  ####  ####  ##########  #  ####  #######  #############  ####  ####
#     #     #           #     #  #     #        #  #  #  #     #     #                 #        #                 #              #              #
####  #  #  ####  #  ####  #  #  #############  #  #  #  ####  #  ####  #  ####  ##########  ##########  ####  #######  #######  #  ####  #  #  #
#     #  #  #     #  #     #  #  #        #                    #     #  #     #  #  #  #              #  #        #  #     #  #     #     #  #  #
#  #######  #  #  #######  #############  ####  #############  #  #######  #  ####  #  #######  #  #############  #  #  ####  ##########  #  #  #
#  #           #              #  #  #  #     #        #  #  #     #     #  #  #                 #     #        #  #              #     #  #  #  #
#######  #############  #######  #  #  #  ####  ####  #  #  ####  ####  #  ####  #  ####  ####  ####  ####  ##########  ##########  ####  #######
#     #     #     #           #  #  #              #  #  #     #     #        #  #     #  #     #           #     #           #  #     #  #     #
#  #  #  #  ####  #######  ####  #  ##########  #######  ####  ####  #  ####  ##########  #  #  #  ####  #  #  #  #  #  #######  #  #######  ####
#  #     #  #        #  #     #     #     #  #                 #  #        #  #  #  #  #  #  #  #  #  #  #  #  #  #  #  #  #     #     #     #  #
#  #######  ####  ####  #  ####  ####  ####  ####  #######  ####  #  #  #######  #  #  ##########  #  #  ####  #  #  ####  ####  ####  #  ####  #
#  #           #     #     #     #        #     #  #           #     #     #              #        #     #     #           #  #        #        #
####  #######  #  #  #  #######  #  ##########  #  #######  #######  ####  ##########  #  #  #  ####  #  ####  #  ##########  #  ##########  ####
#  #     #     #  #  #  #     #     #           #     #  #     #  #     #     #        #  #  #  #     #        #        #     #        #     #  #
#  #  ####  ####  #  #  #  #  ####  #  ####  #  ####  #  #  #  #  #######  #  #  #  #  #  #  ###################  ##########  #  ####  ####  #  #
#  #  #           #  #  #  #        #  #     #  #  #  #  #  #     #  #     #  #  #  #  #        #  #  #                 #        #     #  #     #
#  #  ##########  #######  #  #######  ####  ####  #  #  #  ####  #  ####  #######  ####  ####  #  #  ####  #  ####  ####  #  ####  ####  #  ####
#           #           #  #     #     #        #     #        #     #  #  #     #  #     #     #     #     #     #  #     #  #        #        #
####  #######  #  #  #  #  ####  #  #######  ####  #  ##########  ####  #  #  #######  ####  #######  #  #######  #######  #######  ##########  #
#  #  #  #     #  #  #  #     #  #        #  #     #     #  #     #     #  #  #        #  #  #     #        #  #        #     #     #  B  #  #  #
#  #  #  ####  #  #  #  #######  ####  ####  #  #  ####  #  ####  #  #  #  #  #######  #  ####  #######  ####  #  #  ####  ####  #  #  ####  #  #
#        #     #  #  #                 #     #  #  #        #     #  #           #                 #           #  #           #  #              
##############################################################################################################################################  
