###################################################################
A #       #           #                             #       #     #
# # ####### ### ##### # ############# ##### # ####### ##### # ### #
# #       #   # #     #   #   #     #     # # #   #   #     #   # #
# ####### ### # ####### ### # # ### ####### ### # # ### ####### # #
#       #   # # #       #   #   #         #   # # #   #         # #
####### ### # # # ####### ############### ### # # # ############# #
#   #   #   # #   #       #   #     #   #   #   #   #             #
# ### ### # # ##### ##### # # # ### # ##### ######### #############
# #   #   # # #   #   #   # #     # #     #         #   #         #
# # ### # ### # # ### # ### ####### ##### ######### ### # ####### #
#   # # #       # #   # #     #   #     #       #       # #       #
# ### # ########### ##### ##### # ##### # ####### ####### # ##### #
#   #   # #       #         #   #       #         #     # #   #   #
### # ### # ##### ####### ### ##################### ### # ### # ###
# # # #   # #   #       # #   #       #         #   #   # #   #   #
# # # # ### # ######### ### ### ##### # ####### # ### ### # ##### #
# # #   #   #       #   #   #   #   #     #   # # #   #   # #   # #
# # ### # ### ##### # ### ### ### # ##### # # # # # ### ### ### # #
# #   # #   # #     # #       #   #     # # # #   #       #   # # #
# ### # ### # # ##### ##### ### ####### # # # ##### ######### # # #
# #   # # # # #     #     #   # #   #   # # #     # #   #     #   #
# # ### # # ####### ##### # ### # # # ##### ##### ### # # #########
# #   #   #       #     # # #   # # #     # #         # #         #
# ### ### ####### ### # # # # ### # ##### # ########### ######### #
#   # #     #   #   # # # # #   # #   #   #       #   # #   #   # #
# # # ####### # ### # ### ##### # ##### ######### # ### # # # # # #
# #           #     #           #                 #       #   #   B
###################################################################