   ##########################################################
 A       #           #           #     #  #              #  #
#  #  #############  #  ####  #  #  ####  #  #  #######  #  #
#  #     #     #        #     #     #     #  #        #     #
#  ####  #  #######  ####  ####  #  #  #  #  ####  ####  ####
#  #  #        #     #        #  #     #  #  #     #  #  #  #
#  #  #  ####  #############  #######  #  #######  #  #  #  #
#  #  #  #     #  #           #     #  #        #     #     #
#  #  #######  #  #######  #######  #  ##########  ####  ####
#  #  #     #     #     #     #     #           #  #        #
#  #  #  #######  #  #######  #  ###################  ####  #
#  #     #  #     #     #        #     #        #  #  #  #  #
#  ####  #  #######  #  #  #  ####  #  #  #######  #  #  #  #
#              #     #     #        #     #     #        #  #
#  ####  ################  #  #  #  ####  ####  ####  #  ####
#     #  #     #        #  #  #  #  #  #  #     #     #     #
#  ##########  ####  #  #  ####  ####  #  #  #######  #######
#  #  #  #        #  #  #     #  #     #  #                 #
#  #  #  ####  #  ####  ####  #######  ####  ####  #######  #
#  #     #     #  #        #           #        #  #        #
#  ####  #  #############  #  #  #  ####  ####  ##########  #
#                    #     #  #  #     #  #           #     #
#  #  ####  ####  ####  #  #######  ##########  #######  ####
#  #     #  #           #  #              #     #           #
####  #######  ####  #  #  ####  #############  #  #######  #
#     #     #  #     #  #  #  #  #  #  #        #  #  #     #
#  ####  #######  ##########  #  #  #  #  ####  #  #  #  ####
#  #     #              #  #           #     #  #  #        #
#  #  #  #  #######  ####  #  #  #######  ####  ####  #######
#  #  #        #  #  #        #     #     #     #  #  #     #
#  ####  #  #  #  #############  #  #  #  #  ####  #  ####  #
#  #  #  #  #        #  #     #  #  #  #  #        #  #  #  #
####  #  ####  #  #  #  ####  #  #######  #######  ####  #  #
#  #        #  #  #                 #     #                 #
#  #######  #############  #  #  ####  #######  ##########  #
#                    #     #  #  #           #           #  #
#  #######  ###################  #############  #############
#  #        #  #     #        #                 #           #
##########  #  #  #######  #  #  #  ####  #  #######  ####  #
#                    #     #     #     #  #              #  
##########################################################  B