#####################################################################################################
A       # #       #         #     #       #       #       #   #                     # #             #
####### # # # ### ####### # ##### # # ##### ### # ### # ### # # ### ##### ######### # # ######### # #
# #     #   #   #     #   #       # #       #   #     # #   # # # #   #   #   #   #   # # #       # #
# # ########### ##### # ########### ######### ########### ### # # ### ##### # # # ##### # # ####### #
# #   #         #       #           #         #       #     # #   # # #   # #   #         #   #     #
# ### # ################# ########### ####### # ##### # ##### ### # # # # # ################# #######
#   # # #                 #   #       #     # # # #   # #     #     # # #   # #               #     #
# ### # # ################# # # ##### # ### # # # # ### # ##### ##### # ##### # ############### ### #
#   # #       #             #   #     #   # # # # # #   #       #     # #     #           #   # #   #
# # # ####### # ##################### ### # ### # # # ######### # ### # # ############### # # # # # #
# # #   #     #   #       #         # #   #   #   #   #       # # # # # #   #       #     # #   # # #
### ### ######### # ##### # ####### ### ##### ### ##### ##### ### # # # ### # ##### # ##### ##### # #
#   # #         #       # # #     # #   #       # #     #   #     #   #     #     # #   #   #     # #
# # # ######### ####### # # ##### # # ### ####### # ##### # ### ######### ####### # ### # ### # #####
# #     #       #   #   #         #   #   #       # #     #   # #       # #     # #     # #   # #   #
# ##### # ####### # ##### ############# ### ####### # ####### ### ##### # # ### # ####### # ##### # #
#   #   # #       #     # #           # #   #     #   #   #   #   #   #   #   # #         #       # #
# # ##### ### ######### # # ######### # # ####### ##### # # # # ### ######### # ### ############### #
# #     #   #         # # #   #     #   # #           # # # # # #   #         #   # #   #     #     #
# ##### ### ##### ### # ##### # ### ##### # # ######### # # ### # # # ########### ### # # ### # ### #
# #   #   # #   # #   #       #   #       # # #         # #   #   # #         #       #   # # #   # #
### # # # # # # ### ### ##### # ##### ####### # ######### ### ##### ######### ############# # # # ###
#   # # # # # #     #   #   # # #   #         #         #         #         #   #     #       # #   #
# ### # ### # ########### # ### # # ################### ##### ####### ######### # ##### ####### ### #
#   #   #   #             #     # #                   # #     #   #   #         #     #   #   #   # #
# # ##### ### ################### ################### # ####### # # ### ######### ### ### # ##### # #
# # #     # # #   #     #         #               #     #   #   #     #       #   # #     #   #   # #
# # # ##### # # # # ### # ######### ##### ####### ##### # # # ####### ####### # ### ####### # # ### #
# # #   #       # # # # # #         #   #       #   #   # #     #   # #     # #     # #     #   #   #
### ### ######### # # # # # ######### # ########### # ### ####### # ### ### # ##### # # ######### # #
#     # #   # #   # #     # #     #   #             #   # #   #   #     #   #   # # #   #         # #
# ##### # # # # ### ### ### # # ### ######### ########### ### # ######### ##### # # ##### ##### #####
#     #   # # #   #   # #   # # #   #     #   #               #       #         #         #     #   #
# ### ##### # # ##### ### ##### # # # ### ##### ##################### ##### ##################### # #
#   #     # #   #   #           # # # # #   #     #                 #   # # #                     # #
### ##### # ##### # ############# ### # ### # ##### ############### ### # # # ##################### #
#   # #   # #     #     #       # #   #   #   #   #       #       #   # #   # #   #                 #
# ### # # # # ######### # ##### # # ##### ##### # # ##### ####### ### # ##### ### # ############### #
#   # # # # #     #   #   # #   #             # # # #     #       #   #           #         #   #   #
### # # ### ##### # ####### # ################# # ### ##### ####### ####################### # ### ###
#     #           #                             #     #                                     #       B
#####################################################################################################

